6 8
1 5
2 3
9 5 5 7 9 3 9 3
10 9 5 5 2 14 14 10
10 10 9 7 10 9 5 6
12 2 12 5 4 2 9 3
11 12 5 5 5 2 10 10
12 5 5 5 5 4 6 14
